DDDDDDDD
DDDDDDDD
LDdDDDDd
LLdDDdDD
lDDDDDDD
DDDDDDDd
DdDDDDDD
DDDDDDDD
