DLDDLLLLLD
DLLLlDLLLD
dlLLLDDLlL
LDDLDLLlDL
LLLLDLLLLL
DLlLDDLLLD
DDDLLLdLdD
DDlLLlDLLL
DLDLDLLLDL
LDDDDLDLLD
