LDDDDDDlDDDL
DLLLLLLdLLLD
DdLLLLLLLLdD
LLLLLddLLLdl
LDLLLLLLLLLD
LLLLLdLLLLLD
DLLLLLdLLLLD
DLLLLLLLLLLD
DDLLLLLLLLLD
LDDLLLdLLdLD
DDLLLDLLLLLD
LDDDLLLDDDDL
