DDLDlDLL
DLDDLLDL
DLDDLDLD
DDdDLDdD
DLDLLLLD
DLLDDLdD
DLLLlddL
DDLdLDDD
