LDDDlDDDL
DLLLLLLLD
DLLLdLLLD
DLLLLLLLl
DLLLLLLLD
DLLLdLLLD
DLdLLLLLD
DLdLdLLLD
dDDDDDlDL
