DDDLLLdLL
LLLDlDDDD
LLLDdLLLL
DLDLDDLDD
DDDLLDDLL
lLDDLDDLD
DLLDlLLLD
lDLlLDDDd
LDLDDDDdL
